#####################
# #     #           #
# # # ### ##### # ###
# # #     # #   #   #
# ##### ### # ### ###
#   # #   #   #     #
### # # # ###########
#       #   #   #   #
# ### # ### # # # # #
# #   #   #   #   # #
#####################